 ##  # # ## #    ##   #  # #### ####   #  #  #  # #   ##      #     ###### # #   ## ## #  ##  ## ###
  ##  ## ## #  #   ### #     #     ## ######    #  ########### ####  ##    #   #      ###  #####  # 
#   # ##  ######## # #####   #  ## ## #     ## ### #  #   ## ###  #    #### ####### # # ####  # # ##
 ##            ###     ##### #####    #  ##  # ###    #    #      #  # ## #    ## ### ###  ## ##   #
##### ## ####   # ##    #  # #  # ## #### ##    #### ### # ## ## ###      ###        #   #  ## #    
 ## #  # ## # # ######  # ##  # ####  # #######  ###  ##  # ## # ########## #####  # # #       ##  #
   ###      #  #  #  #### ###  #  # # ##  #       ###   #    #    ##   #      #####  #  ## ### #####
## ####  ### # ## # #   #  # # ## ##      #  ####  # ###### #####    #   ##       # ###  # ###      
    ###### ###  ###  ## #  ###  ## #  ## ####   #  ##    ## #   # ### ###### ###### # ##    ##### ##
# #  ##  #       ### #  ###      # #####  # #   #   #  #    #   #   ###    # ##  ## ######   ## #   
#        ## ## #     #    # ## # ###  # # ####  ## ###########  ## #    ##     #  ##  #  ##     ##  
 ###### # # ##   ### ##   ## #  #  ## ##   #######     ##  ####### ######### #     ## # # # ####### 
#    ##  ## # ###  # ### # ## #  #  ## #     #  #####    #  ##  ##   #  ## #  ## #  ###  ## ##  # ##
#  # ### #  #   # ##   #  # #  #       ##  # ##  ## # ##     #     #  #   ###  #      ## #   #  ####
####  #  # ###### ##### #  ###  ## ### ####   #     # # ## # ## #####   # ####  ## ## #  # # ###  ##
#     ## # ##  #   ## # ## ####  # ###    #   #  ###  #  #  # #    # ## #  ####### #  ## #  #   #  #
# ##   #       #      #     # ###   ######## ##### #  ##  #  ####  ## # #   ##  #  #   #  #  ## #   
# ### ####### ######## ## # ### ##   ##  # # ##  # ######### ## ### ##  ###     ## ## ###### #  ## #
#  ## #   ### ##   # ## #  #     ##    # ##      # #  #        #  ## #      ## # # ## #   #  #   # #
 # ## #     #    #  # ## # #### # # ##  # ##### ## #  #  #####      ###  ##  #  ## #  #   ## ## ##  
##   ### ## # ### # ## ###   ##  ## # #      ## #  # ####     ## ## ##### ##  # #  #####   # ## # # 
   #  ## #  ##  ##   #     #  ## #  #  ##  # ## # ##  # #  ##  # #    # ####### # #    ## ## ## ## #
#####    #   ### #   ## ##### #  #  ## #####  ### # # ##### ###  # ## ##  #   ###   ## ## ##   # ## 
   # ## ### #  # ## # ###  #  ## #####          # ##   ## ### ## # #    # #     ###### #     # #  ##
#  ####  ##  # # ##  #     #   # #  ##### ## ## ## #     #     #   # ##  ### ##  #  #  #  #### ### #
#    # #   #  ##  ##   ### ## ##  #  ## # ## #   # ##  # # ## ###  # # #  ## # #  # # ###     #     
###  ## ##  # ### # #### # ## ### #     #    # # ######  # ## # ###  ## #    ####  ## ##### #  #####
# ##  #######  #  #     ##     #  ###### ##  #  #     # ## #  ### ##  ## ## #  # #  #  ## #  # ##   
   ###  #      #  ### # # ###  #     # ## ### #  ###### #  ###     ### ## #    #### #    ####    ## 
# #  ## #  ######## ### ### ## ##  # #  ### #  # ##  ## # #  #### #     ## ####  #  # ## ## #### #  
#  #   ####    #       #   # # ##### # #   ###     #  ###      ##  ### # ##   #  #  # #    #     #  
 #   #    #  # # ##  # ###  ## ##   ## ### #### ##      ###  # # # ### #  #   ## ###  ####   ## ### 
# ############ # #####    # #     # ##      # # # ## ##  ####  ##   ## ##### # # # #      ##### ####
# #  ##  #    ##  #    ## # #  ## #    ## # ##  # ## # # #  # # ###   #  # #  ## ####  ##    #      
# #    # ## # # # # ### #  ###### # ### # ## #  #    ### # ##  #  # #  # #  # #    #### ##   #  ### 
  ## #  # # # ##  ##  ## #     #  ### ##   # ### ##     ##  ##    #  #  ### # #  # ## ###### #### ##
 # ## #   # ## #   # # ######  # #  ## # # # # #####  # ###   ## ###  # # # ######   #  #  # #   #  
  # #  ###   # ## ## ##  ## #  #     # #  ##     ####    # ### # ####   ##         # #  # ##  ##   #
#  ### # # # #### ##  #     ##  ##   #  # ####    #####  ##  ##   ###### # ###  #### #### ###   ####
## ###  ##  #   #     #  ######* ## ####   ######  ## ##  # # ###  ##   ## ####     #   #  # ##     
    # # # #  ## # ## #####  # ## ## ## #    #   #      ####     #     # #   # ### #  ## #  ## ### ##
### ##  #  # #  ## # ##  #  #### ##   ##### #   # ### #    ##   ######  ### ### #### #  ### ### ##  
   # # ###   #   ##      ###  ##    # ##  ####  #  ##  ### ###    ## # #  ##         #    ##     #  
 # # # #### ### # ##### #   #    ## #       #### #  ## ### # ##    # #       ##  ### ##      ## ### 
## #    ###  ##      ##  ##   ### # # ##  # ## ####     ## ##### # #  ##  ## ####  # ### ###### # # 
  ### #  # #   ##  # ### # ## # ##  ## ###   #   # ####   #   ##  #### #####    # ##   # ##     ##  
# # # #  ## ## #####  #  ## # ## #   # # #   ##  ##     #   #   # #  # #  # ##### #####    ##### # #
# ##  ##  #### ##     ##  ##   #### ## # ## # # # #  ## #### ## # # ## ## ###  #   ## #### ##  # # #
## #   ###  #     ##   ### #     ## ## # ##  ##  #### #  # ## #  ## ##  ##     #               #    
 #### #   # #  ## ### #    ##  #      ##  ## # #    ## #    ## #         #### #######  ## ### #### #
   ##  ##  ######  ##  ### ######## # ### #  ## #### ##### # ###### ## #  ### ##   #### #  ## ## #  
 # ### # #     # #   # ###     ## ###  #  ##  ###   #  ### #   ## ## #      #    #  # ## #  #   ####
##  #  ######  ## ##    #####          #   ###    # #   ## ##    # ## ## ## # ### #  # #### # # #  #
    ###  ## #   ######   ## #####  ###### #   ####  ###   # # ##  # # ## #  ##  ## # #   #  # # # ##
## #  #     ## #  ## ##       #####    ##  ##  # # #  # #   # # #   #    #   ### ##  ##  #  #  ## ##
 #    ######## ##   # #  ##       #  #   # # # # #    ## ###  # #### ### ## #  #  # # # #### #  #  #
  ##     #  ##  # #  ####### ######## ##   ### #  ## # ### #  #  # ##  # ##  # ####  ## ## #### #  #
## ##  # #      # ## ##   ## ##  #  #######   ###  #  #  # ### #    # ##   #  #   ## #   ##  #  #   
 # ##### ## ##  # #     #      # # #  ##  # # # ### #    # # ######## ####  #  ## #  #    #  #  ##  
##      # ## ###  ###### ##  #  ## ##     ### ### # ### ## ##  ##   #  ####### #  ## ##   ##########
##### #  # ### #     # #####  # ##  # ##     #    #  ## #   #    ## #   #   #  #   # ### #   #  #   
 ## # ##  #  ####  #     ####       #  ##  # # ### # ## #   #### #  ### #   ##### ## # #   # ## #   
    # # #  #   ########   ##### ##  ######## # # ###   ### #     #     ### #   ## ## #  ###   #### #
 ###  # ##   #     ## ###  ## #######       ## ##    #   #   ## ###  #   #   # ##   ###   #    ### #
## #  #   ######        #    #  ##   #### # ##  # ######  ##### ########  ####  # # # ######    #   
 # ### ###   ##### ##   ####     # # ## ###     # #  ####    #       #####      #   ###  # ##   ####
 # # ##  #    #  # ###    # ##   #        # ##  # #   # ##   #  ###   #  #  ##  ####   # ##### #    
##  # # ##### # ## # ##   #  ## #### ##   #  ###  # # ###### #### ##  # ###  ####   ##  #    #   ###
# # ### #   ### ## #####  ## ## ## #####  ## # #  #  #  #  # #   # #### # ## #    # # #  ###  #### #
##    # #     #   #   ###### ##   #   ###### # ### # #  # ##  ##  #   # ####  ####  #  # #####    # 
 #  # #### ##   #   #  #  ##    #   #  #  ## ### ### #### ###   #   # ##  ### ## #  ##    #  #  #  #
 ###   ### # ## #### # ##    ## #### #      #  #    #  #   # ## ####       #   # ######## # ### ## #
 # #    #  ## #  # ###  # ### #  # ## ##  #  # ## #    #   ## #  # #  ##   # # # #  #   ### # #    #
   ##   ##  ## #        # # ## # #  #####  #  # ##### ##### ## #   ####### #  ##  # #       ## ### #
###### # ### ###### ##  # ## ### # #  ####  #     ### ##  ## #######  ## #  # ### #### ##### ##  ## 
#    #  #  ##  ## #  ###        ## ##  ####  ##     #          ##  ##   ###    #     # ##     # # # 
 ###  #           ## # #  ##  # ##  #   #### ### ## # ## ###     #  # # ####   # ###      ## ##   ##
 ########  ######### # ######       # #  ###  ## #  ## # ##### #    ###  ##### # ###########   #### 
  #   ######   #  ## ###  ##### ##  # #   # #    #   ##   #  #  ##        ## #    #   ##  # ## #   #
# #          #      #  ##  ## ## ###  ### ## ## ### # ### # ### ###  ####   ###   #    ## ####  ## #
#### #### ### ##  #  #  #      ### #    ## #### ###     ### ###  ####   # # #### ### #  ##  ### #  #
  ## ## #   ##### ##    # ### #  ####        #     ##    ##  # #  # #   # #  ###   #      #  #  ### 
#       ## #  ###   ##  #  ##  #   ### ###   #  ## ### #  #  #### ####  #     # ##  ## ##    #    # 
 ##  ##### ##  # ## #### #  ##   # # # ##### #####  ##    ##   #   # ### #### ######## # ### ##   # 
# ####  ##  #  ####  # ####   #### ##   #  # #  # #   ##   ##  # # ### ##   ##  ##     ##  # ### ###
###  #      #    # # #   # ###    # ##  # ##  # ## ## ### # ## #  #  ## #     #    ###  # ##   # ## 
   # ## ##  ###  ##  ##  ##  #  #  # #### ###  # ####  ##    ## #  #  #### ## # #### #### #####    #
##  # ####### ##  # # # # # ### ##  #   #  # # #   # # # ## # # ##      ## #  #     #  #   ## #### #
  #     ##     ####  ##  ## # #   #  ## #  ### ##  ##  ####   #   ##  #    #  ### #    #            
#####    # ## #  ### # #  # ## ##### #  ###   # ##  # #    ### ### ### ######## # ### #######  ## ##
  #### # # ##  #  #  ## # ## ##      #    # #    # ##   ## # ##  # # ###   #    # ### ##   #### #  #
     #  ## # #    ##  ##   ## #  ### ##   ##### ##  ######  # # ## #     #  ####    #    #  # ## # #
 ###  # ## ## ##   ### #     ####  # ### #  ### ###  #  # # ### ## ## ##### ## # ## # ### #  # ### #
 ######   # # ### #    ##  #    # ##   #         # #  # ##        # ##   #   ### #  ##  ## # #    # 
  #     #   #  ##  ### #### ##### ##### ## ####  #### ## #  ### #    #   # #     #   # # ##  ## #  #
  #  ## #### #  ## ###    ###  #   ## #  # ## #    #   # #### ## ## #### #   ###### ## #  # # ## # #
 #### #  # ## #     ######     #      ##      ##   # # # #   # #### #  #  ###    ## ## ####  # ##  #
  # ## #    ## ###   ##  #### ########### ##########  ##  ##  #     # ####  #  #      #   ##  # ##  
# ## ####### ### ##    #  ### ##   #  # # ##  #     # ### # #   ##### #  ###### ### #  ## # #  # ###
   ##  ##  #    # #  #      #    #    ##   ## #  ####  #  # #####     # #     ### #### #  # ##  #  #
